00000000000000
00000000000000
00000000000000
00000000000000
00000100000000
00000100000000
000001rg000000
0000010b000000
0000011y000000
00000000000000
00000000000000
