9
4
7
6
7
8
7
000000000
000000000
000000000
001111100
00g0b0r00
000000000
000000000
000000000
000000000
