9
3
3
3
2
3
4
3
5
000000000
000000000
000100000
000100000
0001rg000
00010b000
00011y000
000000000
000000000
