7
4
7
5
7
6
7
0000000000
0000000000
0000000000
0000000000
0000001000
0011124300
0000000000
0000000000
0000000000
0000000000
